@ ########################
                  ########
############             # 
###############    #######
##########          ######
######         ###########
#        #################
####    ##################
#     ####################
---------------------------
@           ###############
       ####               #
#      ####              ##
#      ####             ###
##  #######################
##      ###################
###   #####################
#      ####################
#           ###############
---------------------------
@      ###############     
        #############        
         ###########         
          #########           
######                 ####
           #######          
          #########             
         ###########             
        ##############         
----------------------------
@              
#####      ####
               
 #   ###  ###  
               
     #         
               
        #      
               
   ####        
     ##        
     ##   ##   
 #   ##    ##  
     ##    ##  
     #         
-----------------
@     ##   #  #
#####    # ## #
 ##      ####  
 ##        ##  
 ##       ##   
  #  #     ##  
          ##   
###     #      
    #          
   ####   #    
     ##        
###  ##   ##   
 ### ##    ##  
     ##    ##  
     ##### #   
############## 
############## 
## ### #  #    
#              
-----------------                              
@  ####    ####    ####    ####  
   ####    ####    ####    ####  
                                  
####    ####    ####    ####    
####    ####    ####    ####     

   ####    ####    ####    ####     
   ####    ####    ####    ####    
---------------------------------
@  ############################## 
                                #
#  ##############################
#  #                            #
#  ###########################  #
#                               #
##############################  #
#                               #
#  ##############################
#                               #
##############################  #
---------------------------------
@################################
   #                            #
#  #   #######################  #
#  #   #                     #  #
#  #   #  #################  #  #
#  #   #                  #  #  #                                     
#  #  #####################  #  #
#  #                         #  #
#  ###########################  #
#                               #
#################################
----------------------------------










   
     